R 848 480

F 184,113,39

C 51,198,227

NO textures/wall_1.xpm
SO textures/wall_2.xpm
WE textures/wall_3.xpm
EA textures/wall_4.xpm


111111111
 10000001
1000S001
11000001
10100001
111111111
